8.0
16.0
0

#############################
#                  #        #
#        ###########         ##
#        #         #           #
#                  #           #
#        #         #           #
#        #         #           #
#        #         #########   #
################   #           #
#                  #           #
#                              #
#                  #           #
#                  #####       #
#                              #
#                  #           #
#                  #           #
################################
